00222222220000
09########8000
5##0#######820
5###0########6
5####34######6
5####804##0##6
5#####89##0##6
50###########6
040#######0##6
05####P##0##30
05##########60
00111111111100